10 16
################
#              #
#              #
#       ##     #
#       #      #
#       ##     #
#   #          #
#   #          #
#              #
################
